15 15
4 2
1 1 1 1 1 1 1 1 1 1 1 1 1 1 1
1 5 1 1 4 1 1 5 5 1 1 1 1 1 1
1 5 5 5 5 5 5 5 5 1 1 1 1 1 1
1 1 5 5 5 5 5 1 1 1 1 1 1 1 1
1 1 5 5 5 5 5 1 1 1 1 1 1 1 1
1 1 1 1 1 5 5 1 1 1 1 1 1 1 1
1 1 1 1 5 5 5 5 1 1 1 1 5 5 1
1 5 5 5 5 5 5 5 5 1 1 1 5 5 1
1 5 5 5 5 5 5 5 5 1 1 1 5 5 1
1 5 5 5 5 5 5 5 5 5 5 5 5 5 1
1 5 5 5 5 5 5 5 5 5 5 5 5 5 1
1 5 5 5 5 5 5 5 5 5 5 5 5 5 1
1 5 5 5 5 5 5 5 5 5 5 5 5 5 1
1 5 5 5 5 5 5 5 5 1 1 1 1 1 1
1 1 1 1 1 1 1 1 1 1 1 1 1 1 1