21 21
1 1
3 3 3 3 3 3 3 3 3 3 3 3 3 3 3 3 3 3 3 3 6
3 0 0 0 0 0 0 0 0 0 0 0 0 1 1 3 3 0 0 3 6
3 0 0 0 0 0 0 0 0 0 0 0 0 1 1 3 3 0 0 3 6
3 3 3 3 3 3 3 3 0 0 0 0 0 1 1 0 0 0 0 3 6
3 1 1 1 1 1 3 3 0 0 0 0 0 1 1 0 0 0 0 3 6
3 1 1 1 1 1 3 3 0 0 0 0 0 1 1 1 1 0 0 3 6
3 1 1 1 1 1 3 3 0 0 0 0 0 0 1 1 1 0 0 3 6
3 1 1 1 1 1 3 3 0 0 0 0 0 0 0 0 0 0 0 3 6
3 1 1 4 1 1 3 3 0 0 0 0 3 0 0 0 0 0 0 3 6
3 0 0 0 0 3 3 3 0 0 0 0 3 3 0 0 0 0 0 3 6
3 0 0 0 0 0 3 3 0 0 0 0 3 3 0 0 0 0 0 3 6
3 0 0 0 0 0 0 0 0 0 0 0 3 3 0 0 0 0 3 3 6
3 0 0 0 0 0 0 0 0 0 0 0 0 3 0 0 0 0 3 3 6
3 3 3 3 3 3 3 3 0 0 0 0 0 3 0 0 0 3 3 3 6
3 3 3 3 3 3 3 3 0 0 0 0 0 0 0 0 3 3 3 3 6
3 1 0 0 0 0 0 0 0 0 0 0 1 1 1 1 1 1 3 3 6
3 1 0 0 0 0 0 0 0 0 0 0 1 2 2 2 2 1 3 3 6
3 1 0 0 0 0 0 0 0 0 0 0 1 2 2 2 2 1 3 3 6
3 3 3 3 3 3 3 3 3 3 3 3 1 1 1 1 1 1 3 3 6
3 3 3 3 3 3 3 3 3 3 3 3 3 3 3 3 3 3 3 3 6
6 6 6 6 6 6 6 6 6 6 6 6 6 6 6 6 6 6 6 6 6