50 50
1 1
3  3  3  3  3  3  3  3  3  3  3  3  3  3  3  3  3  3  3  3  3  3  3  3  3  3  3  3  3  3  3  3  3  3  3  3  3  3  3  3  3  3  3  3  3  3  3  3  3  3  
3  0  0  0  0  0  0  0  0  6  0  0  8  7  7  3  3  0  0  0  3  3  3  3  3  3  3  3  3  3  3  3  3  3  3  3  3  3  3  3  3  3  3  3  3  3  3  3  3  3
3  0  0  0  0  0  0  0  0  0  0  0  8  7  7  3  3  0  0  0  3  3  3  3  3  3  3  3  3  3  3  3  3  3  3  3  3  3  3  3  3  3  3  3  3  3  3  3  3  3  
3  3  3  3  3  3  3  3  0  0  0  0  8  7  7  8  0  0  0  0  3  3  3  3  3  3  3  3  3  3  3  3  3  3  3  3  3  3  3  3  3  3  3  3  3  3  3  3  3  3
3  1  1  1  1  1  3  3  0  0  0  0  8  7  7  8  0  0  0  0  3  3  3  3  3  3  3  3  3  3  3  3  3  3  3  3  3  3  3  3  3  3  3  3  3  3  3  3  3  3
3  1  8  8  8  1  3  3  0  0  0  0  8  8  8  1  1  0  0  5  3  3  3  3  3  3  3  3  3  3  3  3  3  3  3  3  3  3  3  3  3  3  3  3  3  3  3  3  3  3
3  1  8  8  8  1  3  3  0  0  0  0  0  0  1  1  1  0  0  0  0  0  3  3  3  3  3  3  3  3  3  3  3  3  3  3  3  3  3  3  3  3  3  3  3  3  3  3  3  3
3  1  8  8  8  1  3  3  0  0  0  0  0  0  0  0  0  0  0  0  0  0  3  3  3  3  3  3  3  3  3  3  3  3  3  3  3  3  3  3  3  3  3  3  3  3  3  3  3  3
3  1  1  4  1  1  3  3  0  0  0  0  3  0  0  0  0  0  0  0  3  3  3  3  3  3  3  3  3  3  3  3  3  3  3  3  3  3  3  3  3  3  3  3  3  3  3  3  3  3  
3  0  0  0  0  3  3  3  0  0  0  0  3  3  0  0  0  0  0  0  3  3  3  3  3  3  3  3  3  3  3  3  3  3  3  3  3  3  3  3  3  3  3  3  3  3  3  3  3  3
3  0  0  0  0  0  3  3  0  0  0  0  3  3  0  0  0  0  0  5  3  3  3  3  3  3  3  3  3  3  3  3  3  3  3  3  3  3  3  3  3  3  3  3  3  3  3  3  3  3
3  0  0  0  0  0  3  3  0  0  0  0  3  3  0  0  0  0  3  3  3  3  3  3  3  3  3  3  3  3  3  3  3  3  3  3  3  3  3  3  3  3  3  3  3  3  3  3  3  3
3  0  0  0  0  0  0  0  0  0  0  0  0  3  0  0  0  0  3  3  3  3  3  3  3  3  3  3  3  3  3  3  3  3  3  3  3  3  3  3  3  3  3  3  3  3  3  3  3  3
3  3  3  3  3  3  3  3  0  0  0  0  0  3  0  0  0  3  3  3  3  3  3  3  3  3  3  3  3  3  3  3  3  3  3  3  3  3  3  3  3  3  3  3  3  3  3  3  3  3
3  3  3  3  3  3  3  3  0  0  0  0  0  0  0  0  3  3  3  3  3  3  3  3  3  3  3  3  3  3  3  3  3  3  3  3  3  3  3  3  3  3  3  3  3  3  3  3  3  3  
3  1  0  0  0  0  0  0  0  0  0  0  1  1  1  1  1  1  3  3  3  3  3  3  3  3  3  3  3  3  3  3  3  3  3  3  3  3  3  3  3  3  3  3  3  3  3  3  3  3
3  1  0  0  0  0  0  0  0  0  0  0  1  2  2  2  2  1  3  3  3  3  3  3  3  3  3  3  3  3  3  3  3  3  3  3  3  3  3  3  3  3  3  3  3  3  3  3  3  3
3  1  0  0  0  0  0  0  0  0  0  0  1  2  2  2  2  1  3  3  3  3  3  3  3  3  3  3  3  3  3  3  3  3  3  3  3  3  3  3  3  3  3  3  3  3  3  3  3  3
3  3  0  0  0  3  3  3  3  3  3  3  3  1  1  1  1  1  1  3  3  3  3  3  3  3  3  3  3  3  3  3  3  3  3  3  3  3  3  3  3  3  3  3  3  3  3  3  3  3  
3  3  0  0  0  3  3  3  3  3  3  3  3  3  3  3  3  3  3  3  3  3  3  3  3  3  3  3  3  3  3  3  3  3  3  3  3  3  3  3  3  3  3  3  3  3  3  3  3  3  
3  3  0  0  0  0  0  0  0  0  0  0  0  0  0  3  3  3  3  3  3  3  3  3  3  3  3  3  3  3  3  3  3  3  4  3  3  3  3  3  3  3  3  3  3  3  3  3  3  3
3  3  0  0  3  3  3  3  3  3  3  3  3  3  3  3  3  3  3  3  3  3  3  3  3  3  3  3  3  3  3  3  3  3  7  3  3  3  3  3  3  3  3  3  3  3  3  3  3  3
3  3  0  0  0  0  0  0  0  0  0  0  0  0  0  3  3  3  3  3  3  3  3  3  3  3  3  3  3  3  3  3  3  3  7  3  3  3  3  3  3  3  3  3  3  3  3  3  3  3    
3  3  0  0  0  0  0  0  0  0  0  0  0  0  0  3  3  3  3  3  3  3  3  3  3  3  3  3  3  3  3  3  3  3  7  3  3  3  3  3  3  3  3  3  3  3  3  3  3  3  
3  3  0  0  3  3  3  3  3  3  3  3  3  0  0  3  3  3  3  3  3  3  3  3  3  3  3  3  3  3  3  3  3  3  7  3  3  3  3  3  3  3  3  3  3  3  3  3  3  3
3  3  0  0  3  3  3  3  3  3  3  3  3  0  0  3  3  3  3  3  3  3  3  3  3  3  3  3  3  3  3  3  3  3  7  3  3  3  3  3  3  3  3  3  3  3  3  3  3  3
3  3  0  0  0  0  0  0  0  0  0  0  0  0  0  3  3  3  3  3  3  3  3  3  3  3  3  3  3  3  3  3  3  3  7  3  3  3  3  3  3  3  3  3  3  3  3  3  3  3
3  3  0  0  0  0  0  0  0  0  0  0  0  0  0  3  3  3  3  3  3  3  3  3  3  3  3  3  3  3  3  3  3  3  7  3  3  3  3  3  3  3  3  3  3  3  3  3  3  3
3  3  3  3  3  10 10 10 14 10 10 10 10 10 10 3  3  3  3  3  3  3  3  3  3  3  3  3  3  3  3  3  3  3  7  3  3  3  3  3  3  3  3  3  3  3  3  3  3  3    
3  3  3  3  3  10 9  9  9  9  9  9  9  9  10 3  3  3  10 10 10 3  3  10 10 3  3  3  3  3  3  3  3  3  7  3  3  3  3  3  3  3  3  3  3  3  3  3  3  3  
3  3  3  3  10 10 9  9  9  9  9  9  9  9  10 3  3  10 10 9  10 10 10 9  9  10 3  3  3  3  3  3  3  3  7  3  3  3  3  3  3  3  3  3  3  3  3  3  3  3
3  3  3  3  10 9  9  9  9  9  9  9  9  9  10 10 10 10 2  9  9  9  9  9  9  9  10 10 10 10 3  3  3  3  7  3  3  8  8  8  8  8  8  8  8  8  8  8  3  3
3  3  3  3  10 9  9  9  9  9  9  9  9  9  9  9  9  9  2  9  9  9  9  9  9  9  9  9  9  10 10 10 10 3  7  3  3  8  7  7  7  7  7  7  7  7  7  8  3  3
3  3  3  3  10 9  9  9  9  9  12 9  9  9  9  9  9  9  9  9  9  9  9  9  9  9  9  9  9  9  9  9  10 3  7  3  3  8  7  7  7  7  7  7  7  7  7  8  3  3  
3  3  3  3  10 10 9  9  9  12 10 9  9  9  9  9  9  9  9  9  9  9  9  9  9  9  9  9  9  9  9  9  10 3  7  3  8  8  7  7  7  7  7  7  7  7  7  8  3  3
3  3  3  3  3  10 9  9  9  9  10 10 10 9  9  9  9  9  9  9  9  9  10 10 10 10 9  9  9  9  9  9  10 3  7  3  8  7  7  7  7  7  7  7  7  7  7  8  8  3    
3  3  3  3  3  10 9  9  9  9  9  9  9  9  9  9  9  9  10 10 10 10 3  3  3  3  10 9  9  9  9  9  10 3  7  3  8  7  7  7  7  7  7  7  7  7  7  7  8  3
7  7  7  7  7  10 12 9  9  9  9  9  9  9  9  9  9  10 3  3  3  3  3  3  3  3  10 10 9  9  9  9  10 3  7  7  7  7  7  7  7  7  7  7  7  7  7  7  8  3  
3  3  3  8  8  10 9  9  9  9  9  9  9  9  9  9  9  10 3  3  3  3  3  3  3  3  3  10 9  9  9  9  10 3  3  3  8  7  7  7  7  7  7  7  7  7  7  7  8  3
3  3  3  0  0  14 9  9  9  9  9  9  13 13 9  9  9  9  10 10 10 10 10 10 3  3  3  10 9  9  9  9  10 3  3  3  8  7  7  7  7  7  7  7  7  7  7  8  8  3
3  3  3  3  3  10 9  9  9  9  13 13 13 13 9  9  9  9  9  9  9  9  9  10 10 3  3  10 10 9  9  9  10 3  3  3  8  7  7  7  7  7  7  7  7  7  7  8  3  3  
3  3  3  3  3  10 9  9  13 13 13 13 13 13 9  9  9  9  9  9  9  9  9  10 10 3  3  3  10 9  9  9  10 3  3  3  8  8  7  7  7  7  7  7  7  7  7  8  3  3
3  3  3  3  3  10 9  9  13 9  13 13 13 13 9  9  9  9  9  9  9  9  9  9  10 3  3  3  10 9  9  9  10 3  3  3  3  8  7  7  7  7  7  7  7  7  7  8  3  3    
3  3  3  3  3  10 9  9  13 9  9  13 13 9  9  9  9  9  9  9  9  2  2  9  10 3  3  3  10 9  9  9  10 3  3  3  3  8  7  7  7  7  7  7  7  7  7  8  3  3  
3  3  3  3  3  10 9  9  13 9  9  9  9  9  9  9  9  9  9  9  9  9  2  2  10 3  3  3  10 9  9  9  10 3  3  3  3  8  7  7  7  7  7  7  7  7  8  8  3  3
3  3  3  3  3  10 9  9  13 9  9  9  9  9  9  9  9  9  9  9  9  9  2  2  10 3  3  3  10 9  9  9  10 3  3  3  3  3  8  8  8  8  8  8  8  8  3  3  3  3
3  3  3  3  3  10 10 10 13 10 10 10 10 10 10 10 10 10 9  9  9  9  9  2  10 3  3  3  10 9  9  9  14 0  0  0  0  0  0  0  0  0  0  0  0  0  0  0  0  3
3  3  3  3  3  3  3  3  13 3  10 3  3  3  3  3  3  10 10 10 10 10 10 10 10 3  3  3  3  10 10 10 10 3  3  3  3  3  3  3  3  3  3  3  3  3  3  3  0  3
3  3  3  3  3  3  3  3  13 3  10 3  3  3  3  3  3  3  3  3  3  3  3  3  3  3  3  3  3  3  3  3  3  3  3  3  3  3  3  3  3  3  3  3  3  3  3  3  0  3
3  3  3  3  3  3  3  3  13 3  10 10 10 3  3  3  3  3  3  3  3  3  3  3  3  3  3  3  3  3  3  3  3  3  3  3  3  3  3  3  3  3  3  3  3  3  3  3  3  3
